00000000000000000001000000010000000000000000000000
00000000001000000000011000000010100000000100011001
00000000000000011000100001000000001000010000000000
00000110010000000000000000000010000000100000000000
00000010000100000000101000000000000000000000000000
00000000000001100010000010000000000000000000000000
00000000000000001000000000010000001000000000000000
00011001000000000000010000001000000000000000010001
00000000001000000000000000011000000000000100000000
01000000000010000000010001000000011000000000000000
